11111111111111111111111111111111111111
10100000001000001000000000010000000001
11000001001000010100100000010001000001
10000100101110001001000010010000000001
11000000001000000010000001010000000001
1E000000000000000010000001000000000001
11111111000000000010000001000000100011
10C00P0000000001C100000N00000000000001
11111111111111111111111111111111111111