11111111111111111111111111111
1E000000000000C00000C0000001
11100101001000001010010000101
10100100101000000100100001011
1P000000001C01C10000000000001
11111111111111111111111111111