11111111111111111111111111111
1E0000000000000C00000C0000001
11100101001000001010010000101
10100100101010100010010000101
1P000000001C00C00000000000001
11111111111111111111111111111