1111111111111111111111111111111111111111111111111111111111
1E000000000000C00000C000000100000C001000C110000C000C01C001
1110010100100000101001000C0000010C00000100001000C000000001
101001001011100010010000100000001100000111000000101000C101
1P000000001C00000000000001C00000C000000100000C0001C001C001
1111111111111111111111111111111111111111111111111111111111