11111111111111111111111111111
1E000000000000C00000C00000011
11100101001000001010010000101
10100100101100001001000010111
1P000000001C01000000000001111
11111111111111111111111111111