11111111111111111111111111111111111111
1E00001C001000C00000C000000100000C0011
1000010100100000101001000C0100010C0001
10100100101110001001000010010000111111
10000000001C0000001C000001C10000C00001
1000000000000000001C0000C1000000000001
100100C010C0000C001C0000C1000011000001
1P000C00000C0000001C0000C1000000000C01
11111111111111111111111111111111111111