11111111111111111111111111111
1E0000000000000C00000C0000001
11100101001000001010010000101
101001P0010101000100100001011
10000000001C00C00000000000001
11111111111111111111111111111