11111111111111111111111111111111111111
1E00010C001000C00000C000000100000C0011
1000010100100000101001000C0100010C0001
1010010010111000100100001001000e111111
10000000001C0000001C000001C1000C000001
1000000000000000001C0000C1000000000001
100100C010C0000C001C0000C1000011000001
1P000C00000C0000001C0000C1000000000C01
11111111111111111111111111111111111111