11111111111111111111111111111111111111
1E10010C001000C01000C00000010000C00101
1000010100100000101001000C010001000001
10000100101110001001000010010000111111
10000000001C0000001C000001C10000100001
1000000000000000001C0000C1000000111111
100000C010C0000C001C0000C1000011000111
1P000C0000C0000000C0000C00000000000C01
11111111111111111111111111111111111111