11111111111111111111111111111111111111
1010000C001000C01000C00000010000C00001
110000C100100001010010000C01000100N001
10000100101110001001000010010000000001
10000000001C0000001C000001C1000N000001
100000C0C000000C001C0000C100000C000C01
1111111100C0000C001C0000C1000000100011
1P000000E00000000C01000C0000C000N00001
11111111111111111111111111111111111111