11111111111111111111111111111111111111
1E00000C001000C01000C00000010000C00101
100000C100100001010010000C010001000001
10000100101110001001000010010000000001
10000000001C0000001C000001C10000000001
100000C0C000000C001C0000C100000C000C01
1000000000C0000C001C0000C1000000000011
1P000000000000000C00000C0000C010N00001
11111111111111111111111111111111111111